#################
##+o:       :o+##
#++# ####### #++#
#+#+         +#+#
#+ :OOOo#oOOO: +#
###    +#+    ###
### ####*#### ###
###+++++++++++###
#################