########
##+ O +#
##+ m +#
###o#:##
##+ # +#
## o#:+#
## +# +#
## ## ##
#+ O O+#
#+  O +#
###+++##
########
