#############
#######++####
#+    O :####
#+oo#+ O +###
#+om+#O O +##
##+o # O O +#
#### #: O O #
##+  :  #+ :#
##+++#++#####
#############
