#############
#####+++++###
##### ### +##
#+     +#+ ##
#*oOOO: ##o+#
#+ #+   ## :#
##++##++#+o #
###++####:o:#
####+      +#
#########++##
#############
