#########
###+ :+##
###+#O +#
###+o:o+#
#### O:+#
###+o:m+#
##+# :o+#
#+ oo:#+#
#++++++##
#########
