###############
##+++++++++####
#++#######o####
#+#+      o+###
#+#:::OOO:O:m+#
#+#+      o+#+#
#++#######o#++#
##++++++  o +##
#########+++###
###############
